小玲	Xiǎolíng	Xiaoling, female
阿建	Ājiàn	Ajian, male
聊天室	liáotiānshì	(N) chatroom ( 室 -shì, room)
上班族	shàngbānzú	(N) (office) workers ( 族 -zú, group)
與其	yǔqí	(Conj) rather than
冷清	lěngqīng	(Vs) deserted, empty
高就	gāojiù	(Vi) to work (honorific)
部門	bùmén	(N) department
厲害	lìhài	(Vs) impressive, good, awesome
加班	jiābān	(V-sep) to work overtime
類	lèi	(M) kind, type
恐怖片	kǒngbùpiàn	(N) horror movie ( 恐怖 kǒngbù, scary; 片 -piàn, film)
愛情片	àiqíngpiàn	(N) love story or romance movie ( 愛情 àiqíng, love)
嚇	xià	(Vp) to be scared
哭	kū	(V) to cry
上癮	shàngyǐn	(Vp) to get hooked on, addicted
刺激	cìjī	(Vs) stimulating
簡直	jiǎnzhí	(Adv) simply, really
膽子	dǎnzi	(N) guts, courage
部	bù	(M) measure word for movies
限制級	xiànzhìjí	(N) restricted (viewing for movies) ( 限制 xiànzhì, restricted; 級 -jí, level)
電影院	diànyǐngyuàn	(N) cinema, movie theater
呃	è	(Ptc) uh, interjection indicating embarrassment
建設公司	jiànshè gōngsī	construction company
業務經理	yèwù jīnglǐ	business manager
室內設計	shìnèi shèjì	interior design
溫暖	wēnnuǎn	(Vs) warm
目前	mùqián	(Adv) currently
所	suǒ	(M) measure word for schools
就讀	jiùdú	(Vi) to be enrolled as a student
不至於	búzhìyú	(Adv) not so, not to that degree, not so much that
但	dàn	(Conj) but, however (formal)
放學	fàngxué	(Vp) after school, when school lets out
後	hòu	(N) afterwards (formal)
解決	jiějué	(V) to take care
寂寞	jímò	(Vs) lonely
網友	wǎngyǒu	(N) online friends
陪伴	péibàn	(V) to keep somebody company
電腦	diànnǎo	(N) computer
進入	jìnrù	(V) to enter
線上	xiànshàng	(N) online
感情	gǎnqíng	(N) emotions, feelings, love
小氣	xiǎoqì	(Vs) to be stingy
時	shí	(N) when (formal)
往往	wǎngwǎng	(Adv) oftentimes, generally
打氣	dǎqì	(Vi) to cheer on/up
安慰	ānwèi	(V) to comfort
心裡	xīnlǐ	(N) in (one's) mind'
大膽	dàdǎn	(Vs) to be bold, courageous
紓解	shūjiě	(V) to relieve
轉換	zhuǎnhuàn	(V) to change, transform
虛擬	xūnǐ	(Vs-attr) virtual
現實	xiànshí	(Vs) actual, real
心理	xīnlǐ	(N) psychological, mental
即使	jíshǐ	(Conj) even if, even though
責備	zébèi	(V) to reproach, get on somebody's case'
期待	qídài	(N) expectations
喘氣	chuǎnqì	(V-sep) to gasp, pant
自在	zìzài	(Vs) to be at ease, relaxed
交友	jiāoyǒu	(Vi) to make friends (with)
暴力	bàolì	(N) violence
點	diǎn	(V) to click (on)
懂得	dǒngde	(Vst) to know how to
陷阱	xiànjǐng	(N) trap, snare
明星高中	míngxīng gāozhōng	distinguished ,exclusive high school
早出晚歸	zǎochū wǎnguī	to leave home early and get home late
打開	dǎkāi	to turn on, to power on
喘不過氣	chuǎnbúguò qì	to be under great pressure, (lit.) unable to breathe
躲進	duǒjìn	to hide oneself in
掉進	diàojìn	to fall into
李雲真	Lǐ Yúnzhēn	Li Yunzhen, female
眼睛	yǎnjīng	(N) eye
耳朵	ěrduo	(N) ear
饗宴	xiǎngyàn	(N) feast
打扮	dǎbàn	(V) to put on makeup
音樂廳	yīnyuètīng	(N) music hall, concert hall ( 廳 -tīng, hall)
表演	biǎoyǎn	(N/V) performance; to perform
整齊	zhěngqí	(Vs) neat
穿著	chuānzhuó	(N) attire
丟臉	diūliǎn	(Vs-sep) to lose face, to be embarrassed
短褲	duǎnkù	(N) shorts
涼鞋	liángxié	(N) sandals
擋	dǎng	(V) to block
演出者	yǎnchūzhě	(N) performer ( 演出 yǎnchū, to perform; 者 zhě, person)
尊重	zūnzhòng	(Vst) to respect
社交	shèjiāo	(N) socialization
免得	miǎnde	(Conj) lest, so as not to, to avoid
中場	zhōngchǎng	(N) intermission, halftime
準時	zhǔnshí	(Vs) to be punctual, on time
禮貌	lǐmào	(N) courtesy
或	huò	(Conj) or (formal)
熟	shóu	(Vs) to be familiar with, to be close to somebody
提	tí	(V) to bring up, mention
咳嗽	késòu	(Vi) to cough
關	guān	(V) to close, shut off
哇	wa	(Ptc) yikes, oh no
水準	shuǐzhǔn	(N) class, cultural standard
手冊	shǒucè	(N) programme, manual
洗手間	xǐshǒujiān	(N) restroom ( 間 -jiān, part of 房間 , room)
提醒	tíxǐng	(V) to remind
響	xiǎng	(Vp) to sound
糟	zāo	(Vs) awful
噓	xū	(Ptc) Shh, to hush
看不成	kànbùchéng	to miss out
聯絡感情	liánluò gǎnqíng	to get to know each other better, to strengthen ties with each other
擤鼻涕	xǐng bítì	to blow one's nose'
場	chǎng	(M) measure word for performances
強調	qiángdiào	(V) to stress
團體	tuántǐ	(N) group
千萬	qiānwàn	(Adv) by all means
鋼琴	gāngqín	(N) piano
小提琴	xiǎotíqín	(N) violin
古典	gǔdiǎn	(Vs) classical
畫家	huàjiā	(N) painter
畫	huà	(V/N) to paint; painting
舞蹈	wǔdào	(N) dance
文學	wénxué	(N) literature
繪畫	huìhuà	(N) (act of) painting, drawing
等	děng	(Ptc) etc., and so forth
寺廟	sìmiào	(N) temple
表現	biǎoxiàn	(V/N) to manifest, express; manifestation, expression
之	zhī	(Ptc) of (from classical Chinese, roughly equivalent to the modern Chinese 的 )
劇情	jùqíng	(N) story, plot, storyline
導演	dǎoyǎn	(N) director (movies)
所	suǒ	(Ptc) a verbal marker (marking what comes after as a verb)
紅	hóng	(Vs) popular (of an actress or singer)
明星	míngxīng	(N) movie stars
演技	yǎnjì	(N) acting skills
得	dé	(Vpt) to get, obtain, receive
獎	jiǎng	(N) award
廣場	guǎngchǎng	(N) plaza
或	huò	(Conj) or
仔細	zǐxì	(Adv) carefully, attentively
留意	liúyì	(Vst) to pay attention to, take note of
處處	chùchù	(Adv) everywhere
滿足	mǎnzú	(Vst) to satisfy
豐盛	fēngshèng	(Vs) sumptuous, abundant
國家戲劇院	Guójiā Xìjùyuàn	National Theater
雲門舞集	Yúnmén Wǔjí	Cloud Gate Dance Theatre
國家音樂廳	Guójiā Yīnyuètīng	National Concert Hall
金馬影展	Jīnmǎ Yǐngzhǎn	Golden Horse Film Festival
現代舞	xiàndài wǔ	modern dance
無人不知無人不曉	wúrén bùzhī wúrén bùxiǎo	known to all
百聞不如一見	bǎiwén bùrú yíjiàn	seeing it once is better than hearing about it a hundred times
老街	lǎojiē	old street
街頭藝術	jiētóu yìshù	street art
裝置藝術	zhuāngzhì yìshù	installation art
填飽	tiánbǎo	to fill one's belly'
口腹之慾	kǒufù zhīyù	the desire of one's palate'
李文麗	Lǐ Wénlì	Li Wenli, female
外婆	wàipó	(N) grandma
女裝	nǚzhuāng	(N) women's apparel'
何必	hébì	(Adv) Why bother..., Why must?
指	zhǐ	(Vst) to mean, to indicate
划算	huásuàn	(Vs) cost effective, a good deal
身材	shēncái	(N) figure, build, body (shape)
模特兒	mótèr	(N) model
不見得	bújiàndé	(Adv) not necessarily
仿冒品	fǎngmàopǐn	(N) knock-off, counterfeit product (仿冒 fǎngmào, counterfeit; 品 -pǐn, product)
瑕疵	xiácī	(N) defect
圖片	túpiàn	(N) picture
落差	luòchā	(N) difference
提供	tígōng	(V) to offer
資訊	zīxùn	(N) information
疑問	yíwèn	(N) question, doubt
嘛	ma	(Ptc) sentence particle, ‘it is obvious that''
慣	guàn	(Ptc) to get used to, accustomed to etc…
瀏覽	liúlǎn	(V) to browse, surf (the internet)
後悔	hòuhuǐ	(Vs) to regret, feel sorrowful about
深夜	shēnyè	(N) late at night, in the wee hours
任何	rènhé	(Det) any
駭客	hàikè	(N) hacker
盜用	dàoyòng	(V) to hack, use illegitimately
認證	rènzhèng	(V/N) to certify; certification
銀髮族	yínfǎzú	(N) senior citizens, seniors (銀 yín, silver; 髮 fǎ, hair)
從前	cóngqián	(N) in the past, before, formerly
通常	tōngcháng	(Adv) generally, as a rule
取貨	qǔhuò	(V-sep) to pick up goods
付款	fùkuǎn	(V-sep) to make payment
雲端科技	yúnduānkējì	cloud/internet technology
宅經濟	zháijīngjì	online economy
用不慣	yòngbúguàn	not used/accustomed to using, not comfortable with
退換	tuì huàn	to return, to exchange for something else
信用卡	xìnyòng kǎ	credit card
縮短	suōduǎn	(Vpt) to shorten
人們	rénmen	(N) people in general
距離	jùlí	(N) distance
取代	qǔdài	(V) to replace
信	xìn	(N) letter, mail
影集	yǐngjí	(N) (TV) series
取得	qǔdé	(V) to obtain, access
例如	lìrú	(Vst) for example
民眾	mínzhòng	(N) the public, people in general
高速公路	gāosù gōnglù	(N) highway, freeway
前	qián	(N) before (formal)
查詢	cháxún	(V) to look up, check
路況	lùkuàng	(N) road situation, traffic situation
避開	bìkāi	(V) to avoid
路段	lùduàn	(N) section of road
若	ruò	(Conj) if, supposing
運用	yùnyòng	(V) to use, employ
病歷	bìnglì	(N) medical records
例子	lìzi	(N) example
更加	gèngjiā	(Adv) even more
原本	yuánběn	(Adv) originally
忙碌	mánglù	(Vs) busy
確實	quèshí	(Adv) indeed
控制	kòngzhì	(V) to control
表弟	biǎodì	(N) cousin (younger male cousin from one's mother's side as well as from one's father's sisters)'
退步	tuìbù	(Vp) to regress, get worse, fall behind
過度	guòdù	(Adv) overly, excessively
與	yǔ	(Conj) and (formal)
生理	shēnglǐ	(N) physical health
盯	dīng	(V) to stare
螢幕	yíngmù	(N) screen, monitor
疲倦	píjuàn	(Vs) tired, fatigued
視力	shìlì	(N) vision, eyesight
家長	jiāzhǎng	(N) parent
此外	cǐwài	(Conj) in addition
戶外	hùwài	(N) outdoor
人類	rénlèi	(N) mankind, humans
正面	zhèngmiàn	(Vs) positive
同時	tóngshí	(Adv) at the same time
負面	fùmiàn	(Vs) negative
沉迷	chénmí	(Vs) to be obsessed with, wallow in
無形中	wúxíng zhōng	imperceptibly
遠距教學	yuǎnjù jiāoxué	distance learning
大吵大鬧	dàchǎo dànào	to kick up a row, make a scene, scream bloody murder
焦慮不安	jiāolǜ bù'ān'	to be anxious
總而言之	zǒng'ér yánzhī'	in conclusion, to sum up, in short
該	gāi	(Vaux) should, ought to
擺	bǎi	(V) to place, display
總算	zǒngsuàn	(Adv) finally
欸	èi	(Ptc) hey, calling attention
呀	yā	(Ptc) particle indicating uncertainty
衣櫥	yīchú	(N) closet
梳妝台	shūzhuāngtái	(N) dressing table
位置	wèizhì	(N) position, location
空間	kōngjiān	(N) space
科學	kēxué	(N) science
風水師	fēngshuǐshī	(N) Feng Shui master, geomancer ( 風水 fēngshuǐ, Feng Shui; 師 -shī, master)
在意	zàiyì	(Vs) to care about
所謂	suǒwèi	(V) so-called, what is known as
角度	jiǎodù	(N) angle, perspective
改造	gǎizào	(V) to transform, restructure
學問	xuéwèn	(N) a branch of learning
居住	jūzhù	(Vi) to live, reside
日常	rìcháng	(Vs-attr) daily
布置	bùzhì	(N/V) décor, layout, arrangement; to decorate, to arrange furniture
凶猛	xiōngměng	(Vs) fierce, ferocious
動物	dòngwù	(N) animal
刀	dāo	(N) knife
劍	jiàn	(N) sword
脾氣	píqì	(N) temper
暴躁	bàozào	(Vs) cranky, irritable
衝動	chōngdòng	(Vs) impulsive, rash
鏡子	jìngzi	(N) mirror
床腳	chuángjiǎo	(N) foot of the bed
光	guāng	(Adv) alone, merely
擺飾	bǎishì	(N) décor, ornaments
老婆	lǎopó	(N) wife
把	bǎ	(M) measure word for objects that can be grasped or objects with a handle, e.g., umbrella, knife
欺負	qīfù	(V) to pick on, bully, take advantage of
風水學	Fēngshuǐxué	the study of Feng Shui, geomancy ( 學 -xué, -ology) study,
正對門	zhèng duì mén	directly facing the door
譬如說	pìrú shuō	for example
一口氣	yì kǒu qì	in one breath
死定了	sǐdìngle	(You're) a dead man, You're toast'
地理	dìlǐ	(N) geography
便利性	biànlìxìng	(N) convenience ( 性 -xìng, property, suffix indicating that a term is a noun)
周邊	zhōubiān	(N) surrounding, periphery
住宅	zhùzhái	(N) residence
詞	cí	(N) term,word
西元	Xīyuán	(N) A.D.
推翻	tuīfān	(V) to repudiate, overturn
心中	xīnzhōng	(N) in somebody's heart'
名言	míngyán	(N) well-known saying
建造	jiànzào	(V) to build
塑造	sùzào	(V) to shape
命運	mìngyùn	(N) fate, destiny
本身	běnshēn	(N) itself, oneself
地標	dìbiāo	(N) landmark
參考	cānkǎo	(V/N) to make reference to; reference
外觀	wàiguān	(N) exterior, appearance
疊	dié	(V) to stack
盆子	pénzi	(N) basin
斜	xié	(Vs) slanted, tilted
牆面	qiángmiàn	(N) wall face
聚寶盆	jùbǎopén	(N) treasure basin, similar to a cornucopia but filled with treasure ( 聚 -jù, to gather; 寶 -bǎo, treasure; 盆 -pén, basin)
角	jiǎo	(N) corner
龍	lóng	(N) dragon
古	gǔ	(Vs-attr) ancient (formal)
錢幣	qiánbì	(N) coins,currency
屋頂	wūdǐng	(N) roof
龜	guī	(N) turtle, tortoise
招財	zhāocái	(Vi) to attract treasure
側門	cèmén	(N) side door, side gate
遮雨棚	zhēyǔpéng	(N) canopy, awning
如意	rúyì	(N) ruyi, scepter, s-shaped ornamental object that brings good luck
設計	shèjì	(N/V) design; to design
偶然	ǒurán	(Vs) random, accidental, chancy
晉代	Jìn Dài	Jin Dynasty
郭璞	Guō Pú	Guo Pu
英國	Yīngguó	the UK
邱吉爾	Qiūjí'ěr'	Churchill
信義路	Xìnyì Lù	Xinyi Road
松智路	Sōngzhì Lù	Songzhi Road
一命二運三風水	yímìng èryùn sānfēngshuǐ	Fate is most important. Luck is second. Feng Shui is third.
加起來	jiāqǐlái	to add up, totalize
咬錢龜	yǎoqián guī	money-biting turtle
十全十美	shíquán shíměi	perfect, pinnacle of perfection
夢	mèng	(N) dream
排隊	páiduì	(V-sep) to line up, stand in queue
校刊	xiàokān	(N) school newspaper, school publications of all sorts
採訪	cǎifǎng	(V) to interview
校友	xiàoyǒu	(N) alumnus
博士	bóshì	(N) doctorate, PhD
學位	xuéwèi	(N) academic degree
考	kǎo	(V) to take a test
司機	sījī	(N) driver, chauffeur
學士	xuéshì	(N) bachelor's, college degree'
地攤	dìtān	(N) street stall
現象	xiànxiàng	(N) phenomenon
稀奇	xīqí	(Vs) rare (and unique), singular
搶	qiǎng	(V) to rob, mug
批評	pīpíng	(V) to criticize
浪費	làngfèi	(Vst) to waste
畢竟	bìjìng	(Adv) after all
貢獻	gòngxiàn	(V) to make contributions
的確	díquè	(Adv) indeed
盲目	mángmù	(Adv) blindly
升學	shēngxué	(Vi) to pursue further education
逃避	táobì	(V) to evade, escape
就業	jiùyè	(N/Vi) employment; to get a job
延後	yánhòu	(V) to postpone
啃老族	kěnlǎozú	(N) a “sponge”, a “parasite”, somebody who feeds off the old (啃老 kěnlǎo, gnaw on the old) live off one's parents, lit. gnaw on the old)'
收攤	shōutān	(V-sep) to close up shop (said of street stalls)
清潔隊員	qīngjiéduìyuán	cleaning squad, street cleaners ( 清潔 qīngjié, to clean; 隊員 -duìyuán, team member)
擺地攤	bǎi dìtān	to have a street stall
大多數	dàduōshù	most, the majority of
話說回來	huàshuō huílái	on the other hand, however
自食其力	zìshí qílì	to rely on yourself, to stand on your own two feet
下一期	xiàyìqí	next issue (of a periodical)
段	duàn	(M) a period of (time)
物價	wùjià	(N) prices, commodity prices
上漲	shàngzhǎng	(Vp) to rise (of prices)
所得	suǒdé	(N) income
漲	zhǎng	(Vp) to rise (as of prices and water level)
勉強	miǎnqiǎng	(Adv) barely, with great reluctance
根本	gēnběn	(Adv) at all, in the slightest
組織	zǔzhī	(N) organization
抗議	kàngyì	(V) to protest against
地價	dìjià	(N) land prices
房價	fángjià	(N) housing prices
高漲	gāozhǎng	(Vs) to (upward) surge
造成	zàochéng	(Vpt) to cause, produce, make
統計	tǒngjì	(N) statistics
窮忙	qióngmáng	(Vs) busy doing things without achieving anything
全球	quánqiú	(N) global, worldwide
景氣	jǐngqì	(Vs) prosperous, booming, economic conditions
施行	shīxíng	(V) to implement, put into effect
薪資	xīnzī	(N) pay, salary, wages
多年	duōnián	(N) for many years, for so long
未	wèi	(Adv) not yet (formal)
調高	tiáogāo	(V) to adjust upward
裁員	cáiyuán	(Vi) to lay off
觀察	guānchá	(V) to observe, note
彩券	cǎiquàn	(N) lottery
中獎	zhòngjiǎng	(Vp-sep) to win (a prize or lottery), to hit a jackpot
做夢	zuòmèng	(V-sep) to dream
發財	fācái	(Vp-sep) to strike it rich
臉色	liǎnsè	(N) countenance (mood shown on face)
報導	bàodǎo	(N) report, article, story (news)
指出	zhǐchū	(V) to indicate, point out
創業	chuàngyè	(Vi) to set up a business
餐飲業	cānyǐnyè	(N) food and beverage industry
人生	rénshēng	(N) life
及	jí	(Conj) and (formal)
挑戰	tiǎozhàn	(N) challenge
培養	péiyǎng	(V) to cultivate, train, foster
實力	shílì	(N) strength (not physical strength)
等待	děngdài	(V) to wait for, await
擁有	yǒngyǒu	(Vst) to have as one's own, possess'
中國大陸	Zhōngguó Dàlù	Mainland China
存不了	cúnbùliǎo	can't save (money)'
無殼蝸牛	wúké guāniú	"snails without shells" (people who can't afford to buy their own home)'
貧富不均	pínfù bùjūn	gap between the rich and the poor, unequal distribution of wealth
苦哈哈	kǔ hāhā	bitter life, very poorly
另謀發展	lìngmóu fāzhǎn	to seek opportunities elsewhere
恨不得	hènbùdé	to be dying to, desperately
一夜致富	yíyè zhìfù	to become rich overnight
一片天	yípiàntiān	place in the sun, a job that makes you happy and provides you with all the money and things that you want, paradise
高來恩	Gāo Lái'ēn'	a man from Switzerland
地震	dìzhèn	(N) earthquake
搖	yáo	(Vp) to rock, shake
厲害	lìhài	(Vs) fierce, formidable
經常	jīngcháng	(Adv) frequently
倒	dǎo	(Vp) to collapse
橋	qiáo	(N) bridge
斷	duàn	(Vp) to break, snap
多	duó	(Adv) so
地區	dìqū	(N) region
強烈	qiángliè	(Vs) strong
頻率	pínlǜ	(N) frequency
預測	yùcè	(V) to predict, forecast
徵兆	zhēngzhào	(N) sign, omen
鳥類	niǎolèi	(N) birds
雞	jī	(N) chicken
預先	yùxiān	(Adv) in advance
老鼠	lǎoshǔ	(N) mouse, rat
貓	māo	(N) cat
馬	mǎ	(N) horse
證實	zhèngshí	(V) to verify
應變	yìngbiàn	(Vi) to meet an emergency
隨手	suíshǒu	(Adv) within easy reach
白	bái	(Adv) in vain
嫌	xián	(Vst) to grumble
事前	shìqián	(Adv) in advance
總是	zǒngshì	(Adv) always
西歐	Xī Ōu	Western Europe
北歐	Běi Ōu	Northern Europe
中歐	Zhōng Ōu	Central Europe
澳洲	Àozhōu	Australia
南美洲	Nán Měizhōu	South America
地球科學	dìqiú kēxué	earth science studies
菲律賓	Fēilǜbīn	the Philippines
天搖地動	tiānyáo dìdòng	swaying heavens and trembling earth, earth-shaking
壓死	yāsǐ	crushed to death
災情慘重	zāiqíng cǎnzhòng	in serious disaster
東半部	dōngbànbù	the eastern half
地震帶	dìzhèn dài	seismic zone, earthquake belt
救生包	jiùshēng bāo	survival kit, survival pack
有備無患	yǒubèi wúhuàn	be prepared, be on the safe side
如何	rúhé	(Adv) how
逃生	táoshēng	(Vi) to evacuate
發達	fādá	(Vs) advanced, developed
天災	tiānzāi	(N) natural disaster
災害	zāihài	(N) disaster, damage (from a disaster)
程度	chéngdù	(N) degree, level
首先	shǒuxiān	(Adv) first of all
其次	qícì	(Adv) second, next, then
災難	zāinàn	(N) disaster
緊急	jǐnjí	(Vs) in emergency
必需品	bìxūpǐn	(N) necessities ( 必需 bìxū, essential, indispensable)
譬如	pìrú	(Vst) for example, like
手電筒	shǒudiàntǒng	(N) flashlight, torch
餅乾	bǐnggān	(N) crackers, cookies
平時	píngshí	(N) in ordinary times
狀況	zhuàngkuàng	(N) situation,circumstance
慌張	huāngzhāng	(Vs) to panic, be flustered
停電	tíngdiàn	(Vp-sep) to have a power outage
黑暗	hēi'àn'	(N) the darkness
方向	fāngxiàng	(N) direction
集合	jíhé	(Vi) to meet, assemble
裂縫	lièfèng	(N) crack
瓦斯	wǎsī	(N) natural gas
開關	kāiguān	(N) switch
火災	huǒzāi	(N) fire (disaster), conflagration
門框	ménkuāng	(N) door frame
歪	wāi	(Vp) askew, slanted, crooked
頭部	tóubù	(N) head
冷靜	lěngjìng	(Vs) cool-headed, calm
穩	wěn	(Vs) steady
櫃子	guìzi	(N) closet, cabinet
牆壁	qiángbì	(N) wall
倒塌	dǎotā	(Vp) to collapse
電梯	diàntī	(N) elevator
反而	fǎn'ér'	(Conj) on the contrary, rather
堅固	jiāngù	(Vs) strong, firm, solid
柱子	zhùzi	(N) pillar, column
碰	pèng	(V) to hit, bump into
形成	xíngchéng	(V) to form
三角形	sānjiǎoxíng	(N) triangle
保持	bǎochí	(V) to remain, stay
平靜	píngjìng	(Vs) calm
指示	zhǐshì	(N) instructions, commands
救援	jiùyuán	(Vi) to rescue
行動	xíngdòng	(N) activity, action, operations
掉下來	diàoxiàlái	to fall down, to drop
倒下來	dǎoxiàlái	to fall over, to collapse
救災人員	jiùzāi rényuán	rescue personnel
博文	Bówén	a senior in college
玉珍	Yùzhēn	a sophomore in college
學妹	xuémèi	(N) female lower classmate (see culture notes)
學弟	xuédì	(N) male lower classmate
彈	tán	(V) to play (piano, guitar)
吉他	jítā	(N) guitar
交	jiāo	(V) to submit, hand in
家教	jiājiào	(N) coach, tutor
學長	xuézhǎng	(N) male upper classmate
還	hái	(Adv) to one's surprise'
進度	jìndù	(N) progress
落後	luòhòu	(Vp) to fall behind, lag
完成	wánchéng	(Vpt) to complete
一連	yìlián	(Adv) in a row, in succession
約會	yuēhuì	(V-sep) to make a date/appointment
一生	yìshēng	(N) (for) one's life'
時光	shíguāng	(N) time
倒流	dàoliú	(Vp) to flow backward
加強	jiāqiáng	(V) to strengthen
至少	zhìshǎo	(Adv) at least
訓練	xùnliàn	(N/V) training; to train
外國	wàiguó	(N) other countries, abroad, foreign
爭取	zhēngqǔ	(V) to vie for, compete for
實習	shíxí	(Vi) to intern
二分之一	èrfēn zhīyī	1/2
一下...一下...	yíxià...yíxià...	measure phrase, describing fast-changing alternating scenes of two activities
到時候	dào shíhòu	at that time, when the time comes
談戀愛	tán liàn ài	to be in love, go steady (said of dating couples)
低空飛過	dīkōng fēiguò	barely managed to pass (a test, course)
有助於	yǒuzhùyú	to help in something, be beneficial to something
寒暑假	hánshǔ jià	winter and summer vacations
暗戀	ànliàn	(V) to have a crush on someone
目光	mùguāng	(N) eyes, gaze
移動	yídòng	(Vi) to move
於是	yúshì	(Conj) so, whereupon
原來	yuánlái	(Adv) the truth is
煩惱	fánnǎo	(Vs) to be troubled, vexed
擔任	dānrèn	(V) to hold the post of
學生會	xuéshēnghuì	(N) student union ( 會 -huì, organization)
會長	huìzhǎng	(N) president of an association, club etc... ( 長 -zhǎng, head)
校隊	xiàoduì	(N) school team
隊員	duìyuán	(N) team member ( 員 -yuán, member, person)
高大	gāodà	(Vs) tall and big, bulky
帥氣	shuàiqì	(Vs) dashing, handsome
雙	shuāng	(M) a pair of
開朗	kāilǎng	(Vs) cheerful
微笑	wéixiào	(Vi) to smile
情人節	qíngrénjié	(N) Valentine's Day ( 節 -jié, holiday, day)'
親手	qīnshǒu	(Adv) personally, with one's own hands'
巧克力	qiǎokèlì	(N) chocolate
當天	dāngtiān	(N) that day
堆	duī	(M) a pile of
向	xiàng	(Prep) to
告白	gàobái	(Vi) to confess
萬人迷	wànrénmí	(N) heartthrob ( 迷 -mí, charmer)
交往	jiāowǎng	(Vi) to go steady, to date
系花	xìhuā	(N) department beauty, the most beautiful girl in a department
追	zhuī	(V) to chase, woo
情書	qíngshū	(N) love letter
態度	tàidù	(N) attitude
曖昧	àimèi	(Vs) ambiguous (about one's relationship)'
甜蜜	tiánmì	(Vs) sweet
溫柔	wēnróu	(Vs) tender
訊息	xùnxí	(N) message
忌妒	jìdù	(Vst) to be jealous
安全感	ānquángǎn	(N) the feeling of security ( 感 -gǎn, sense/feeling of)
吃醋	chīcù	(Vp-sep) to be jealous
吵架	chǎojià	(V-sep) to quarrel, fight, argue
牽	qiān	(V) to hold
吻	wěn	(V) to kiss
劈腿	pītuǐ	(Vp-sep) to two-time
糟糕	zāogāo	(Ptc) oh no, how terrible, what bad luck!
何清源	Hé Qīngyuán	a male college student
林榮華	Lín Rónghuá	a male college student
一見鍾情	yíjiàn zhōngqíng	love at first sight
一舉一動	yìjǔ yídòng	every move
前一天	qián yì tiān	the day before
已讀不回	yǐdú bùhuí	read without reply
王麗華	Wáng Lìhuá	a woman from Taiwan
魯亞	Lǔ Yǎ	a man from Turkey
論文	lùnwén	(N) thesis, dissertation, scholarly article
反正	fǎnzhèng	(Adv) in any case
不只	bùzhǐ	(Adv) not only
哈	hā	(Ptc) ha
代替	dàitì	(V) to substitute, to be in place of
獨自	dúzì	(Adv) alone, by oneself
難免	nánmiǎn	(Adv) inevitably, hard to avoid
費用	fèiyòng	(N) costs, expense
觀念	guānniàn	(N) concept, notion
代	dài	(N) generation
婚姻	hūnyīn	(N) marriage
束縛	shùfú	(V) to be fettered by, bound by, shackled by
追求	zhuīqiú	(V) to pursue
倒是	dàoshì	(Adv) on the other hand
推行	tuīxíng	(V) to promote
生育	shēngyù	(V/N) to have babies; reproduction, childbirth
補助	bǔzhù	(V/N) to subsidize; subsidy, allowance
老人	lǎorén	(N) old people, seniors
夫婦	fūfù	(N) husband and wife, couple ( 夫 -fū, man; 婦 fù, woman)
獨生子	dúshēngzǐ	(N) only child (male)
寵	chǒng	(Vst) to spoil (somebody)
職業	zhíyè	(N) occupation, profession
婦產科	fùchǎnkē	(N) obstetrics and gynecology, OB/GYN ( 婦 -fù, woman; 產 -chǎn, produce; 科 -kē, department)
失業	shīyè	(Vp) to lose one's job, to become unemployed'
補習班	bǔxíbān	(N) cram school ( 補習 bǔxí, supplement studies; 班 -bān, class)
不可思議	bùkě sīyì	hard to comprehend, beyond logic, unbelievable
有話直說	yǒuhuà zhíshuō	to be frank, don't hold anything back, spit it out'
娃娃推車	wáwa tuīchē	baby carriage
不足為奇	bùzú wéiqí	nothing strange, not surprising at all
遠遠	yuǎnyuǎn	by far
傳宗接代	chuánzōng jiēdài	carry on the family line
無拘無束	wújū wúshù	carefree, free, do as one pleases
老一輩	lǎoyíbèi	the older generation
一胎化政策	yìtāihuà zhèngcè	One Child Policy
這下子	zhèxiàzi	as a consequence
已	yǐ	(Adv) already (formal)
生育率	shēngyùlǜ	(N) birth rate ( 率 -lǜ, rate)
離婚	líhūn	(Vp-sep) to get divorced
年齡	niánlíng	(N) age
較	jiào	(Adv) comparatively more (formal)
使	shǐ	(Vst) to cause
行業	hángyè	(N) businesses, walks of life
重大	zhòngdà	(Vs) enormous, heavy
幼稚園	yòuzhìyuán	(N) kindergarten
招生	zhāoshēng	(Vi) to recruit students, find students
減班	jiǎnbān	(Vp-sep) to reduce enrollments
將	jiāng	(Adv) will soon
少子化	shǎozǐhuà	(Vp) low birth rate ( 少 , few; 子 , children; 化 huà, -ize, suffix indicating transformation)
連鎖	liánsuǒ	(Vs-attr) chain, franchise
兒童	értóng	(N) child (ren)
美語	Měiyǔ	(N) (American) English
倒閉	dǎobì	(Vp) to go out of business
何況	hékuàng	(Adv) much less, let alone
無法	wúfǎ	(Adv) to be unable to
未來	wèilái	(N) future
遠景	yuǎnjǐng	(N) future prospects
足夠	zúgòu	(Vs) enough
加入	jiārù	(V) to enter, join
老化	lǎohuà	(Vp) aging
針對	zhēnduì	(Prep) aimed at, directed at
項	xiàng	(M) item
措施	cuòshī	(N) measure
減稅	jiǎnshuì	(V-sep) to reduce taxes, tax break
延長	yáncháng	(V) to extended, make longer
產假	chǎnjià	(N) maternity leave
托育	tuōyù	(N) childcare
胎	tāi	(N) embryo, birth, child
領	lǐng	(V) to receive, withdraw (money)
元	yuán	(N) dollar (or other currency)
成年	chéngnián	(Vp) to come to age, enter adulthood
除非	chúfēi	(Conj) unless
整體	zhěngtǐ	(N) overall
否則	fǒuzé	(Conj) otherwise
婦女	fùnǚ	(N) woman
意願	yìyuàn	(N) intention
祖父母	zǔfùmǔ	(N) paternal grandparents
孫女	sūnnǚ	(N) granddaughter
重	zhòng	(Vs) heavy
預算	yùsuàn	(N) budget
財政	cáizhèng	(N) finance
沉重	chénzhòng	(Vs) heavy
有效	yǒuxiào	(Vs) effective
正	zhèng	(Adv) during the process of
考驗	kǎoyàn	(V) to test out
智慧	zhìhuì	(N) wisdom
之一	zhīyī	one of
寧缺勿濫	níngquē wùlàn	not settle for less than perfect
合不來	hébùlái	not get along
生兒育女	shēng'ér yùnǚ'	to have and raise children
獨善其身	dúshàn qíshēn	to look out only for oneself, be self-centered
停滯不前	tíngzhì bùqián	in stagnation
逐漸	zhújiàn	(Adv) gradually
據點	jùdiǎn	(N) base, stronghold
統治	tǒngzhì	(V) to rule, govern
景點	jǐngdiǎn	(N) scenic site
繁榮	fánróng	(Vs) prosperous
港口	gǎngkǒu	(N) harbor, port
據說	jùshuō	(V) it is said
鹿	lù	(N) deer
鹿群	lùqún	(N) herd of deer ( 群 -qún, group, crowd)
形狀	xíngzhuàng	(N) shape
鹿角	lùjiǎo	(N) deer antlers
便	biàn	(Adv) accordingly
稱	chēng	(V) to call
動物園	dòngwùyuán	(N) zoo
皮	pí	(N) skin, hides
殺	shā	(V) to kill
數量	shùliàng	(N) number, quantity
風光	fēngguāng	(N) glory
民宅	mínzhái	(N) home, people's residence'
蚵仔煎	ézǐjiān	(N) oyster omelet
哦	ó	(Ptc) an interjection indicating concurrence accepting what has been presented
該	gāi	(Vaux) should, ought to (formal)
興盛	xīngshèng	(Vs) flourishing
時期	shíqí	(N) period, age
獨木舟	dúmùzhōu	(N) canoe
為	wéi	(Vst) as
載運	zàiyùn	(V) to transport
改名	gǎimíng	(V-sep) to legally change one's names'
相似	xiāngsì	(Vs) similar
沒落	mòluò	(Vp) to decline, wane
依然	yīrán	(Adv) still
保留	bǎoliú	(V) to remain intact, preserve
鹿港	Lùgǎng	Lugang
艋舺	Měngjiǎ	Mengjia (Mangka)
淡水河	Dànshuǐ Hé	Tamsui River ( 河 hé,river)
萬華	Wànhuá	Wanhua
台語	Táiyǔ	Taiwanese (a Southern Min dialect)
日語	Rìyǔ	Japanese (language)
家喻戶曉	jiāyù hùxiǎo	widely known
滿山遍野	mǎnshān biànyě	all over the mountains and plains
古色古香	gǔsè gǔxiāng	to have an antique air, quaint, classical in style
綠豆糕	lǜdòu gāo	mung-bean cake
牛舌餅	niúshé bǐng	ox-tongue biscuit
垂涎三尺	chuíxián sānchǐ	to salivate over, make one's mouth water'
數目	shùmù	(N) amount, quantity
大約	dàyuē	(Adv) about, approximately
佔	zhàn	(Vst) constitute (same as “ 占” )
自從	zìcóng	(Prep) ever since
將近	jiāngjìn	(Adv) nearly, almost
往來	wǎnglái	(N) dealings, contact
思念	sīniàn	(Vst) to miss, think about, long for
通信	tōngxìn	(V-sep) to communicate, correspond by mail
毫無	háowú	(Vst) none whatsoever
音訊	yīnxùn	(N) news, information, message
遠離	yuǎnlí	(Vst) to have left far away from
妻子	qīzi	(N) wife (literary)
永遠	yǒngyuǎn	(N) always, forever
開放	kāifàng	(Vp) to open to the public
探親	tànqīn	(Vi) to visit relatives
親人	qīnrén	(N) relatives, loved ones
打聽	dǎtīng	(V) to ask about, inquire
不禁	bùjīn	(Adv) can't help but'
淚	lèi	(N) tears
尚未	shàngwèi	(Adv) not yet
出世	chūshì	(Vp) to be born
童年	tóngnián	(N) childhood
傷心	shāngxīn	(Vs) sad
筆	bǐ	(M) sum (of money)
仍然	réngrán	(Adv) still
原諒	yuánliàng	(Vst) to forgive
盡	jìn	(V) to exhaust, do one's utmost'
究竟	jiùjìng	(Adv) after all, in the end, actually
內心	nèixīn	(N) in one's heart, heart of hearts, innermost being'
創傷	chuāngshāng	(N) trauma, scars
珍惜	zhēnxí	(Vst) to cherish, treasure
精華	jīnghuá	(Vs-attr) prime
逃難	táonàn	(Vi) to flee from war, natural disaster etc
實在	shízài	(Adv) truly, really
歲月	suìyuè	(N) years, time
遭遇	zāoyù	(N/V) (unhappy) experiences, happenings; to encounter, to have met with
老兵	lǎobīng	(N) old soldier, veteran
老張	Lǎo Zhāng	Lao Zhang, a nickname for someone whose surname is Zhang
文化大革命	Wénhuà Dà Gémìng	Cultural Revolution (1966 ~ 1976)
落地生根	luòdì shēnggēn	to set one's roots down'
身強體壯	shēnqiáng tǐzhuàng	strong and healthy
離鄉背井	líxiāng bèijǐng	to leave one's hometown to become a stranger elsewhere'
飄洋過海	piāoyáng guòhǎi	to sail cross the sea
朝思暮想	zhāosī mùxiǎng	to be amiss day and night
一輩子	yíbèizi	one lifetime
恐懼不安	kǒngjù bù'ān'	scared and anxious, suffering from constant fear
刻骨銘心	kègǔ míngxīn	unforgettable, to be imprinted hard in one's mind'
何建明	Hé Jiànmíng	a male college graduate
應徵	yìngzhēng	(V) to apply for a job
配	pèi	(V) to go with, match
領帶	lǐngdài	(N) tie
花	huā	(Vs) fancy, flowery, garish
素色	sùsè	(N) plain (in color)
剩下	shèngxià	(Vpt) to remain, left (over)
龍頭	lóngtóu	(N) head, leader
起薪	qǐxīn	(N) starting salary
福利	fúlì	(N) (work) benefits
具備	jùbèi	(Vst) to have in one's qualification'
限制	xiànzhì	(N) restrictions
以上	yǐshàng	(N) above, over, more than
以下	yǐxià	(N) below, under, fewer than
相關	xiāngguān	(Vs) related, relevant
各位	gèwèi	(N) you (plural, formal)
應屆	yìngjiè	(Vs-attr) this year's, upcoming'
畢業生	bìyèshēng	(N) graduate
大一	dàyī	(N) freshman, first-year university student ( 大二 sophomore, 大三 junior, 大四 senior)
企劃部	qìhuàbù	(N) planning department ( 部 -bù, department)
營運	yíngyùn	(N) operations
知識	zhīshì	(N) knowledge
社長	shèzhǎng	(N) club president
聯合	liánhé	(Adv) jointly
音樂會	yīnyuèhuì	(N) concert
節目	jiémù	(N) program, show, event
好評	hǎopíng	(N) positive comments, praise
企劃	qìhuà	(V/N) to plan (used in business); a plan
領導	lǐngdǎo	(V) to lead
合作	hézuò	(Vi) to cooperate with, work with
似乎	sìhū	(Adv) seem
關於	guānyú	(Prep) related to, regarding
磨練	móliàn	(N/V) training, hone a skill; to train, hone, or to practice over time
優點	yōudiǎn	(N) strong point, forte
上司	shàngsī	(N) supervisor, boss
誇獎	kuājiǎng	(V) to praise, commend
週	zhōu	(M) week
內	nèi	(N) within
以	yǐ	(Prep) to use (formal)
書面	shūmiàn	(N) in writing
通知	tōngzhī	(V/N) to notify; a notification
就...而言	jiù...éryán	as far as...are concerned
新鮮人	xīnxiānrén	freshman, (here) a person, usually a college graduate, new or “fresh” to the workforce
面試官	miànshì guān	interviewing officer
自我介紹	zìwǒ jièshào	self-introduction
所學有限	suǒxué yǒuxiàn	what has been learned is only rather limited
出國	chūguó	(V-sep) to go abroad
資金	zījīn	(N) capital, funds
廠商	chǎngshāng	(N) manufacturer
例外	lìwài	(N) exception
關	guān	(N) hurdle
接觸	jiēchù	(V) to come in contact with, to contact
青年	qīngnián	(N) young people, youth
貸款	dàikuǎn	(N) loan
開店	kāidiàn	(V-sep) to open a store
料	liào	(N) material, (here) a person not suited for…
損失	sǔnshī	(Vpt) to lose
勇氣	yǒngqì	(N) courage
員工	yuángōng	(N) employee
求職	qiúzhí	(Vi) to seek employment
目標	mùbiāo	(N) target, (here) the most ideal job
初步	chūbù	(Vs-attr) preliminary, initial
技巧	jìqiǎo	(N) tips
概念	gàiniàn	(N) concept, idea
挑	tiāo	(V) to select, pick
基本	jīběn	(Vs) basic
襯衫	chènshān	(N) button-up shirt
過程	guòchéng	(N) process
同班	tóngbān	same class
是...的料	shì...de liào	to be gifted in…
接下來	jiēxiàlái	and then, next
提不起 （勇氣）	tíbùqǐ (yǒngqì)	unable to raise...to a high level to pump up (enough courage)
養家活口	yǎngjiā huókǒu	support one's family'
來自	láizì	from 來 + literary preposition 自“ from” = 從...來
熟讀	shóudú	to keep reading something until one remembers everything
考古題	kǎogǔtí	test items from previous years ( 題 -tí, for test items)
沙盤推演	shāpán tuīyǎn	to rehearse; a dry run, a practice run
深藍色	shēn lánsè	dark blue
種族	zhǒngzú	(N) ethnic group, race
熔爐	rónglú	(N) melting pot, smelting furnace, crucible
偏偏	piānpiān	(Adv) deliberately, insist on
肯	kěn	(Vaux) be willing to
母語	mǔyǔ	(N) mother tongue
口音	kǒuyīn	(N) accent
適應	shìyìng	(V) to adapt to, get used to
了不起	liǎobùqǐ	(Vs) terrific, amazing, really something
交流	jiāoliú	(Vi) to exchange, associate
志工	zhìgōng	(N) volunteer
縣	xiàn	(N) county
市	shì	(N) city
外籍	wàijí	(Vs-attr) foreign national
配偶	pèi'ǒu'	(N) spouse
焦慮	jiāolǜ	(Vs) to be anxious
溝通	gōutōng	(N) communication
障礙	zhàng'ài'	(N) obstacle, handicap
良好	liánghǎo	(Vs) positive
以往	yǐwǎng	(Adv) formerly, heretofore
面對	miànduì	(V) to face, confront
衝擊	chōngjí	(N) impact
大眾	dàzhòng	(N) the public, the masses
難以	nányǐ	(Adv) to find it difficult to
認同	rèntóng	(V) to identify with, accept
跨國	kuàguó	(Vs-attr) transnational
大量	dàliàng	(Adv) in large quantities
移入	yírù	(V) to immigrate ( 入 , enter, into (formal))
憂慮	yōulǜ	(Vst) to worry
降低	jiàngdī	(V) to reduce, lower
素質	sùzhí	(N) quality
歧視	qíshì	(Vst) to discriminate
子女	zǐnǚ	(N) children (from 兒子+女兒)
資產	zīchǎn	(N) asset, resource
應	yīng	(Vaux) should, ought to (formal)
平等	píngděng	(N) equality
相互	xiānghù	(Adv) mutually, each other
外人	wàirén	(N) outsider
聯絡	liánluò	(V) to contact, to connect with
小明	Xiǎomíng	Xiaoming, a nickname
家長日	jiāzhǎngrì	parents' day'
氣人	qìrén	exasperating, annoying
照說	zhào shuō	to keep on saying…
在...之餘	zài...zhīyú	to do something at a time when not doing…
本地人	běndì rén	local people
自己人	zìjǐrén	one of us, one of our own, compatriots
哪裡!哪裡!	nǎlǐ nǎlǐ	not at all, not a problem, you're welcome'
漸漸	jiànjiàn	(Adv) gradually
曾	céng	(Adv) have been before, was once (formal)
嘗試	chángshì	(V/N) to try (something new), attempt; an attempt
結構	jiégòu	(N) structure
產生	chǎnshēng	(Vp) to take place, produce
轉變	zhuǎnbiàn	(N) change, transformation
嬰兒	yīng'ér'	(N) baby
雙親	shuāngqīn	(N) both parents
本國	běnguó	(N) our country
國籍	guójí	(N) nationality
大陸籍	Dàlùjí	(N) from Mainland China, (lit. Mainland nationality) (籍 -jí, nationality)
其	qí	(Det) his, her, its, their (formal)
比例	bǐlì	(N) ratio (percentage)
根本	gēnběn	(Vs) fundamental
可見	kějiàn	(Conj) it is obvious that, it is clearly seen that
現有	xiànyǒu	(Vs-attr) current, existing
分配	fēnpèi	(N/V) distribution, to distribute, allocate
顧慮	gùlǜ	(Vst) to be concerned about
學童	xuétóng	(N) school children
身心	shēnxīn	(N) physical and mental, mind and body
缺乏	quēfá	(Vst) to lack
課業	kèyè	(N) school work
指導	zhǐdǎo	(N/V) guidance; to give guidance to
輔導	fǔdǎo	(V) to counsel
輸	shū	(Vp) to lose out (opposite of win)
失去	shīqù	(Vp) to lose (an item), lack
然而	rán'ér'	(Conj) but, on the other hand, however
觀點	guāndiǎn	(N) perspective
加速	jiāsù	(V) to accelerate
創下	chuàngxià	(Vpt) to set (a record)
紀錄	jìlù	(N) record
明顯	míngxiǎn	(Vs) significant, obvious
下降	xiàjiàng	(Vp) to decrease
趨勢	qūshì	(N) trend
高齡化	gāolínghuà	(Vp) for a population to become aged/geriatric
世代	shìdài	(N) generation
不足	bùzú	(Vs) insufficient, not adequate
持續	chíxù	(Vaux) to continue, to keep on
正視	zhèngshì	(V) to face squarely, pay due attention to
國語	Guóyǔ	Mandarin
客語	Kèyǔ	Hakka, a Chinese (Han) dialect
最多數	zuìduōshù	the greatest majority
總人數	zǒng rénshù	total population
起跑點	qǐpǎodiǎn	starting line
新生兒	xīnshēng'ér'	a newborn baby
生產力	shēngchǎn lì	productivity
一較長短	yíjiào chángduǎn	to compete, to compare against
王安康	Wáng Ānkāng	Wang Ankang, male
張定能	Zhāng Dìngnéng	Zhang Dingneng, male
美好	měihǎo	(Vs) wonderful, beautiful
當選	dāngxuǎn	(Vpt) to be elected to an office
無所謂	wúsuǒwèi	(Vs) I don't care; does not bother me'
敏感	mǐngǎn	(Vs) sensitive
化學	huàxué	(N) chemical, chemistry
添加物	tiānjiāwù	(N) additives
殘留	cánliú	(N) residue
修改	xiūgǎi	(V) to amend
法規	fǎguī	(N) laws and regulations, statutes
安養	ānyǎng	(N) to care for, to provide nursing care to all people
河川	héchuān	(N) river and stream
脫離	tuōlí	(Vpt) to separate oneself from, break away from
背景	bèijǐng	(N) background
領域	lǐngyù	(N) area (of study, etc.), (here) walk of life
竟然	jìngrán	(Adv) unexpectedly, surprisingly
總統	zǒngtǒng	(N) president
保障	bǎozhàng	(N/V) security (e.g., job security), to guarantee
特權	tèquán	(N) special privileges
把持	bǎchí	(V) to control
監督	jiāndū	(V) to oversee, monitor, supervise
罷免	bàmiǎn	(V) to recall, remove from office
權	quán	(N) power, authority
廉能	liánnéng	(Vs) clean and capable
富足	fùzú	(Vs) affluent, abundant
在乎	zàihū	(Vst) to care about
生命	shēngmìng	(N) life
財產	cáichǎn	(N) property, assets
義工	yìgōng	(N) volunteer
選戰	xuǎnzhàn	(N) (election) campaign
承諾	chéngnuò	(N/V) promise; to promise
帶領	dàilǐng	(V) to lead
力量	lìliàng	(N) power
擺脫	bǎituō	(V) to rid of
困境	kùnjìng	(N) dire situation, straits
房地產	fángdìchǎn	real estate
小自...大至...	xiǎozì...dàzhì...	from such trivialities to such major concerns (自 from (formal); 至 to (formal))
是否	shìfǒu	whether or not
照理說	zhào lǐ shuō	normally
政治人物	zhèngzhì rénwù	politicians
受苦	shòu kǔ	suffering
富裕	fùyù	(Vs) rich, affluent
貪汙	tānwū	(Vp) to graft, to demand
腐敗	fǔbài	(Vs) corruption
政爭	zhèngzhēng	(N) political infighting
停滯	tíngzhì	(Vp) to stagnate, stall
上升	shàngshēng	(Vp) to rise
信心	xìnxīn	(N) confidence
遊民	yóumín	(N) street people, the homeless
外界	wàijiè	(N) the outside world
悲慘	bēicǎn	(Vs) miserable, tragic
日子	rìzi	(N) days, life
如此	rúcǐ	(Adv) such, so
巨大	jùdà	(Vs) enormous
無能	wúnéng	(Vs) incompetent
冷漠	lěngmò	(Vs) apathetic
學者	xuézhě	(N) scholars
階層	jiēcéng	(N) class hierarchy (in society)
自然	zìrán	(Adv) naturally
阻止	zǔzhǐ	(V) to prevent, block
遙遠	yáoyuǎn	(Vs) remote
無論	wúlùn	(Conj) no matter, regardless
明明	míngmíng	(Adv) clearly, obviously
骯髒	āngzāng	(Vs) dirty
顧	gù	(V) to care about
自身	zìshēn	(N) one's own'
政客	zhèngkè	(N) politico
縱容	zòngróng	(V) to condone, tolerate
使得	shǐde	(Vst) to make, to cause
工廠	gōngchǎng	(N) factory
密集	mìjí	(Vs) crowded with high density of
遭受	zāoshòu	(Vst) to suffer from, be subjected to
困苦	kùnkǔ	(Vs) distressed
老人年金	lǎorén niánjīn	annuity payment for senior citizens (provided by The National Pension Program in Taiwan)
無家可歸	wújiā kěguī	homeless, no home to go back to
以...為...	yǐ...wéi...	taking... as... (formal)
漠不關心	mòbù guānxīn	indifferent
發言權	fāyán quán	right to speak, (here) a voice (in politics, etc.)
影響力	yǐngxiǎng lì	influence
官商勾結	guānshāng gōujié	collusion between politicians and business people
貧富懸殊	pínfù xuánshū	a huge gap between the rich and the poor
息息相關	xíxí xiāngguān	inextricably related to
